# Syntax Colouring Map For LedArr

# Data types (KEYWORD1)
LedArr    KEYWORD1


# Methods and Functions (KEYWORD2)
mRGB      KEYWORD2
pixels    KEYWORD2
LedStrStruc	KEYWORD2

InitLedArr	KEYWORD2
ScrClear	KEYWORD2
ClearLine	KEYWORD2
GetLedCol	KEYWORD2
GetLedColI	KEYWORD2
SetLedCol	KEYWORD2
GetColors	KEYWORD2
RefreshLedArr	KEYWORD2
DisplayChar	KEYWORD2
LoadString	KEYWORD2
SetScrollSpeed	KEYWORD2
DisplayString	KEYWORD2



# Constants (LITERAL1)
SCR_SIZE 	LITERAL1
MAXCOL	LITERAL1
SCRX  	LITERAL1
SCRY  	LITERAL1
SCR_NO_MEMORY_ERR	LITERAL1
SCR_OK           	LITERAL1
LED_PIN	LITERAL1
NUM_LEDS	LITERAL1
BRIGHTNESS	LITERAL1
UPDATES_PER_SECOND	LITERAL1
FNT_Size 	LITERAL1
FNT_COUNT	LITERAL1
MSG_MAXCHAR   	LITERAL1
